     SO           textures/south.xpm
DO textures/door.xpm
WE textures/west.xpm
NO    textures/north.xpm    
F            111         ,                    111,  111
EA textures/east.xpm
C 0,255,232,
                
111111111111111     
1S0000000000001       
10000000000C001    
100000100001D11
1000C0D0C000001
100000100000001
111111111111111
