     SO           textures/south.xpm                
WE textures/west.xpm
NO    textures/north.xpm    
F            111         ,                    111,  111
EA textures/east.xpm
C 0,255,232,
                
111111111111111     
10000000000S001       
10000000000C001    
100000100000001
1000C0D0C000001
100000100000001
111111111111111
