     SO           textures/south.xpm
DO textures/door.xpm
WE textures/west.xpm
NO    textures/north.xpm    
F            111         ,                    111,  111
EA textures/east.xpm
C 0,255,1

                
111111111111111     
1000C0000000001       
100000000000001    
100000100001D11
100W00D00000001
100000100000001
111111111111111


