SO textures/south.xpm
WE textures/west.xpm

F 23,100,0
C 255,255,2ola32

111111111111111
100000000000001
100000000000001
100000100000001
100000000000001
100000010000001
100001000000001
100000000000001
100000000000001
111111111111111





















































       NO                      textures/north.xpm      






























































EA textures/east.xpm