SO textures/south.xpm
WE textures/west.xpm
NO    textures/north.xpm    
EA textures/east.xpm

F 111,111,111
C 255,255,232

 1
101111111111111
100000000000001
100S00000000001
100000100000001
100000000000001
100000010000001
111111111111111
					
					



