WE textures/west_wall.xpm
     SO           textures/south_wall.xpm
NO    textures/north_wall.xpm    
F            111         ,  111, 123
EA textures/east_wall.xpm
C 0,255,    1

 1                
101111111111111     
10000000000S001       
100000000010001    
10000000001001
100000001000001
100000000000001
100000000010001    
10000000001001
100000001000001
100000000000001
100000000010001    
10000000001001
100000001000001
100000000000001
100000000010001    
10000000001001
100000001000001
100000000000001
100000000010001    
10000000001001
100000001000001
100000000000001
100000000010001    
10000000001001
100000001000001
100000000000001
100000000010001    
10000000001001
100000001000001
100000000000001
100000000010001    
10000000001001
100000001000001
100000000000001
100000000010001    
10000000001001
100000001000001
100000000000001
100000000010001    
10000000001001
100000001000001
100000000000001
100000000010001    
10000000001001
100000001000001
100000000000001
111111111111111




