SO textures/south.xpm
WE textures/west.xpm
NO    textures/north.xpm      
EA textures/east.xpm

F 111,111,111
C 255,255,232

111111111111111
100000000000001
100000000000001
100000100000001
10000000000001
100000010000001
100011100111001
10001 10S1 1111
10001 1001 1101
11111 1001 1111
10001 1001 1001
10001 1001 1001
1000111001 1001
100000000111001
100000010000001
100001000000001
100000000000111
100000000000001
111111111110111
111111111110111

1111111111111
1111   111101
1111  1001101
1111  1000001
11111 11111111